111111111111
1110P0000E11
111111111111
