111111111111111111111111111111111111111111111111111111111111111111111111111111111
1PCCCCCCCCCCCCCCCCCCCCCCCC00000C000000000000000000000000000000000000C0000C0000CC1
1000000000000000000000000C00000C000000000000000000000000000000000000C0000C000ECC1
111111111111111111111111111111111111111111111111111111111111111111111111111111111
