11111111111111111111111111111111111111111111111111111111111111111111111111111111
100000P000000000000000000C00000C000000000000000000000000000000000000C0000C0000C1
1000000000000000000000000C00000C000000000000000000000000000000000000C0000C0000C1
1000000000000000000000000C00000C000000000000000000000000000000000000C0000C0000C1
1000000000000000000000000C00000C000000000000000000000000000000000000C0000C0000C1
1000000000000000000000000C00000C000000000000000000000000000000000000C0000C0000C1
1000000000000000000000000C00000C000000000000000000000000000000000000C0000C0000C1
1000000000000000000000000C00000C000000000000000000000000000000000000C0000C0000C1
1000000000000000000000000C00000C000000000000000000000000000000000000C0000C0000C1
1000000000000000000000000C00000C000000000000000000000000000000000000C0000C0000C1
1000000000000000000000000C00000C000000000000000000000000000000000000C0000C0000C1
1000000000000000000000000C00000C000000000000000000000000000000000000C0000C0000C1
1000000000000000000000000C00000C000000000000000000000000000000000000C0000C0000C1
1000000000000000000000000C00000C000000000000000000000000000000000000C0000C0000C1
1000000000000000000000000C00000C000000000000000000000000000000000000C0000C0000C1
1000000000000000000000000C00000C000000000000000000000000000000000000C0000C0000C1
1000000000000000000000000C00000C000000000000000000000000000000000000C0000C0000C1
1000000000000000000000000C00000C000000000000000000000000000000000000C0000C0000C1
1000000000000000000000000C00000C000000000000000000000000000000000000C0000C0000C1
1000000000000000000000000C00000C000000000000000000000000000000000000C0000C0000C1
1000000000000000000000000C00000C000000000000000000000000000000000000C0000C0000C1
1000000000000000000000000C00000C000000000000000000000000000000000000C0000C0000C1
1000000000000000000000000C00000C000000000000000000000000000000000000C0000C0000C1
1000000000000000000000000C00000C000000000000000000000000000000000000C0000C0000C1
1000000000000000000000000C00000C000000000000000000000000000000000000C0000C0000C1
1000000000000000000000000C00000C000000000000000000000000000000000000C0000C0000C1
1000000000000000000000000C00000C000000000000000000000000000000000000C0000C0000C1
1000000000000000000000000C00000C000000000000000000000000000000000000C0000C0000C1
1000000000000000000000000C00000C000000000000000000000000000000000000C0000C0000C1
1000000000000000000000000C00000C000000000000000000000000000000000000C0000C0000C1
1000000000000000000000000C00000C000000000000000000000000000000000000C0000C0000C1
1000000000000000000000000C00000C000000000000000000000000000000000000C0000C0000C1
1000000000000000000000000C00000C000000000000000000000000000000000000C0000C0000C1
1000000000000000000000000C00000C000000000000000000000000000000000000C0000C0000C1
1000000000000000000000000C00000C000000000000000000000000000000000000C0000C0000C1
1000000000000000000000000C00000C000000000000000000000000000000000000C0000C0000C1
1000000000000000000000000C00000C000000000000000000000000000000000000C0000C0000C1
1CCCCCCCCCCCCCCCCCCCCCCCCC00000C000000000000000000000000000000000000C0000C0000C1
1CCCCCCCCCCCCCCCCCCCCCCCCC00000C000000000000000000000000000000000000C0000C0000C1
1000000000000000000000000C00000C000000000000000000000000000000000000C0000C0000C1
1000000000000000000000000C00000C000000000000000000000000000000000000C0000C0000C1
1000000000000000000000000C00000C000000000000000000000000000000000000C0000C000EC1
11111111111111111111111111111111111111111111111111111111111111111111111111111111
