111111111111
100CCCCPCCC1
1EEEEEEEEEE1
111111111111
